30,30
0
00031300000000000400
00300010000000000100
00100002111300000200
00300000000010001000
00010000000002120000
00003111200000000000
00000000010000000000
00000000001000000000
00003130000100000000
00010001000031120000
00300000300000001000
00100000100000000200
00300000100000000100
00010000100000000100
00001000200000000200
00000200010000001000
00000100001000010000
00000100000211200000
00000X00000000000000
00000000000000000000

# start at X, end at 4
# 1 = forward, 3 = right, 2 =left
